o	o	r	o	o	o	o	o	o	o	o	o	o	o	o	o	o	o	o	o	o	o	o	o	o	o	o	o	o	o	o	o	o	o	o	o	o	o	o	o	o	o	o	o	o	o	o	o	o	o	o	o	o	o	o	o	o	o	o	o	o	o	o	o	o	o	o	o	o	o	o	o	o	o	o	o	o	o	o	o
o	w	p	w	w	w	w	w	w	w	w	w	w	w	w	w	w	w	w	w	w	w	w	w	w	w	w	w	w	w	w	w	w	w	w	w	w	w	w	w	w	w	w	w	w	w	w	w	w	w	w	w	w	w	w	w	w	w	w	w	w	w	w	w	w	w	w	w	w	w	w	w	w	w	w	w	w	w	w	o
o	w	p	w	w	p	p	p	p	p	p	p	p	p	p	p	p	p	p	p	p	p	p	p	p	p	p	p	p	p	p	p	p	p	p	p	p	p	p	p	p	p	p	p	p	p	p	p	p	p	p	p	p	p	p	p	p	p	p	p	p	p	p	p	p	p	p	p	p	p	p	p	p	p	p	p	p	p	w	o
o	w	p	w	w	p	w	p	w	w	w	w	w	w	w	w	w	w	w	w	w	p	w	w	w	w	w	w	p	w	w	w	w	w	w	w	w	w	w	w	w	w	w	w	p	w	w	w	p	w	w	w	w	w	w	w	w	w	w	w	w	w	w	w	w	w	w	w	w	w	w	w	w	w	w	w	w	p	w	o
o	w	p	w	w	p	w	p	w	p	w	w	w	w	p	w	w	w	w	w	w	w	w	w	w	w	w	w	w	p	p	w	p	p	p	p	p	p	p	p	p	p	p	w	p	w	w	w	p	w	p	p	p	p	p	p	w	p	p	p	p	p	p	w	p	p	p	w	w	p	p	p	p	p	p	p	w	p	w	o
o	w	p	w	w	p	w	p	w	p	p	p	p	p	p	p	p	p	p	p	p	p	p	p	p	p	p	w	w	p	w	w	p	w	w	w	w	w	w	w	w	w	w	w	p	w	w	w	p	w	p	w	w	w	w	p	w	p	w	w	w	w	p	w	p	w	p	w	w	p	w	w	w	w	w	p	w	p	w	o
o	w	p	w	w	p	w	p	w	p	w	p	w	w	p	w	w	w	w	w	w	w	p	w	w	w	w	w	w	p	w	w	p	w	w	w	w	w	w	w	w	w	w	w	p	w	w	w	p	w	p	w	w	w	w	p	w	p	w	w	w	w	p	w	p	w	p	w	w	p	w	w	w	w	w	w	w	p	w	o
o	w	p	w	w	p	w	p	w	p	w	p	w	w	p	w	w	w	w	w	w	w	p	w	w	w	w	w	w	p	w	w	p	w	w	w	w	w	w	w	w	w	w	w	p	w	p	w	p	w	p	w	w	w	w	p	w	p	w	w	w	w	p	w	p	w	p	w	w	p	p	w	w	w	w	w	w	p	w	o
o	w	p	w	w	p	w	p	w	p	w	p	w	w	p	w	p	p	p	p	p	w	p	w	w	w	p	w	w	p	w	w	p	w	w	w	w	w	w	w	w	w	w	w	p	w	p	w	p	w	p	w	w	w	w	p	w	p	w	w	w	w	p	p	p	w	p	p	p	p	w	p	p	p	p	p	p	p	w	o
o	w	p	w	w	p	w	p	w	p	w	p	w	w	p	w	p	w	w	w	p	w	p	w	w	w	p	w	w	p	w	w	p	w	w	w	w	w	w	w	w	w	w	w	p	w	p	w	p	w	p	w	w	w	w	p	w	p	w	w	w	w	w	w	w	w	w	w	w	p	w	p	w	w	w	w	w	p	w	o
o	w	p	w	w	p	w	p	w	p	w	p	w	w	p	w	p	w	p	p	p	w	p	w	w	w	p	w	w	p	w	w	p	w	w	w	w	w	w	w	w	w	w	w	p	w	p	w	p	w	p	w	w	w	w	p	w	p	w	p	p	p	p	p	p	p	p	p	w	p	w	p	w	w	w	w	w	p	w	o
o	w	p	w	w	p	w	p	w	p	w	p	w	w	p	w	p	w	w	w	w	w	p	w	w	w	p	w	w	p	w	w	p	w	w	w	w	w	w	w	w	w	w	w	p	w	p	p	p	w	p	w	w	w	w	p	w	p	w	p	w	p	w	w	w	w	w	p	w	p	w	p	p	p	w	p	w	p	w	o
o	w	p	w	w	w	w	p	w	p	w	p	w	w	p	w	p	p	p	p	p	p	p	p	p	p	p	p	p	p	p	p	p	w	w	w	w	w	w	w	w	w	w	w	p	w	w	p	w	w	p	w	w	w	w	p	w	p	w	p	w	p	w	w	w	w	w	p	w	p	w	p	w	p	w	p	w	p	w	o
o	w	p	p	p	p	p	p	p	p	w	p	w	w	p	w	p	w	w	p	w	w	p	w	w	w	p	w	w	w	w	w	p	w	w	w	w	w	w	w	w	w	w	w	p	w	w	p	w	w	p	w	w	w	w	p	w	p	w	p	w	p	w	w	w	w	w	p	w	p	w	p	w	p	w	p	w	p	w	o
o	w	w	w	w	p	w	p	w	p	w	p	w	w	p	w	p	w	w	p	w	w	p	w	w	w	p	w	w	w	w	w	p	p	p	p	p	p	p	p	p	w	w	w	p	w	w	p	w	w	p	w	w	w	w	p	w	p	w	p	w	p	w	w	w	w	w	p	w	p	w	p	w	p	w	p	w	p	w	o
o	w	p	w	w	p	w	p	w	p	w	p	w	w	p	w	p	w	w	p	w	w	p	w	p	w	p	w	w	w	w	w	w	w	w	p	w	w	w	w	p	w	w	w	p	w	w	p	w	w	p	w	w	w	w	p	w	p	w	p	w	p	w	w	w	w	w	p	w	p	w	p	w	p	w	p	w	p	w	o
o	w	p	w	w	p	w	p	w	p	w	w	w	w	p	w	p	w	w	p	w	w	p	w	p	w	p	w	w	w	w	w	w	w	w	p	w	w	w	w	p	p	p	w	p	w	w	p	w	w	p	w	w	w	w	p	w	p	w	p	w	p	w	w	w	w	w	p	w	p	p	p	w	p	w	p	w	p	w	o
o	w	p	w	w	p	w	p	w	p	w	w	w	w	p	w	p	w	w	p	w	w	p	w	p	w	p	w	p	p	p	p	p	p	p	p	w	w	w	w	p	w	p	w	p	w	w	p	w	w	p	w	w	w	w	p	w	p	w	p	w	p	w	w	w	w	w	p	w	p	w	p	w	p	w	p	w	p	w	o
o	w	p	w	w	p	w	p	w	p	w	w	p	w	w	w	p	w	w	p	w	w	p	w	p	w	p	w	w	w	w	w	w	w	w	p	w	w	w	w	p	w	p	w	p	w	w	p	w	w	p	w	w	w	w	p	w	p	w	p	w	p	w	w	w	w	w	p	w	p	w	w	w	p	w	p	w	p	w	o
o	w	p	w	w	p	w	p	w	p	w	w	p	w	w	w	p	w	w	p	w	w	p	w	p	w	p	w	w	w	w	w	w	w	w	p	w	w	w	w	p	w	p	w	p	w	w	p	w	w	p	w	w	w	w	p	w	p	w	p	w	p	w	w	w	w	w	p	p	p	w	p	p	p	p	p	w	p	w	o
o	w	p	w	w	p	w	w	w	w	w	w	p	w	w	w	p	w	w	p	w	w	p	w	p	w	p	w	w	w	w	w	w	w	w	p	w	w	w	w	p	w	p	w	p	w	w	p	w	w	p	w	w	w	w	w	w	p	w	p	w	p	w	w	w	w	w	w	w	w	w	w	w	w	w	w	w	p	w	o
o	w	p	w	w	p	w	w	w	w	w	w	p	w	w	w	p	w	w	p	w	w	p	w	p	w	p	w	w	w	w	w	w	w	w	p	w	w	w	w	p	w	p	w	p	w	w	w	w	w	p	w	w	w	w	w	w	p	w	p	w	p	w	w	w	w	w	w	w	w	w	w	w	w	w	w	w	p	w	o
o	w	p	w	w	p	w	w	w	w	w	w	p	w	w	w	p	w	w	p	w	w	p	w	p	w	p	w	w	w	w	w	w	w	w	p	w	w	w	w	p	w	p	w	p	w	w	w	w	w	p	w	w	w	w	w	w	p	w	p	w	p	p	p	p	p	p	p	p	p	p	p	p	p	p	w	w	p	w	o
o	w	p	w	w	p	w	p	w	p	w	w	p	w	w	w	p	w	w	p	w	w	p	w	p	w	p	w	p	w	w	w	p	w	w	p	w	w	w	w	p	w	p	w	p	w	w	w	w	w	p	w	w	w	w	w	w	p	w	p	w	p	w	w	w	w	w	w	w	w	w	w	w	w	p	w	w	p	w	o
o	w	p	w	w	p	w	p	w	p	w	w	p	w	w	w	p	w	w	p	w	w	p	w	p	w	p	w	p	w	w	w	p	w	w	p	w	w	w	w	p	w	p	w	p	p	p	p	p	p	p	p	p	p	p	p	w	p	w	p	w	p	w	w	p	w	p	p	p	w	p	p	p	w	p	w	w	p	w	o
o	w	p	w	w	p	w	p	w	p	w	w	p	w	w	w	p	w	w	p	w	w	p	w	p	w	p	w	p	p	p	w	p	w	w	p	w	w	w	w	p	w	p	w	p	w	w	w	p	w	w	w	w	w	p	w	w	p	w	p	w	p	w	w	p	w	p	w	p	w	p	w	p	w	p	w	w	p	w	o
o	w	p	p	p	p	p	p	p	p	w	w	p	w	w	w	p	w	w	p	w	w	p	w	p	w	p	w	p	w	w	w	p	w	w	p	w	w	w	w	p	w	p	w	p	w	w	w	p	w	w	w	w	w	p	w	w	p	w	p	w	p	w	w	p	w	p	w	p	w	p	w	p	w	p	w	w	p	w	o
o	w	p	w	w	w	w	w	p	w	w	w	p	w	w	w	p	w	w	p	w	w	w	w	p	w	p	w	p	w	w	w	p	w	w	p	w	w	w	w	p	w	p	w	p	w	w	w	p	w	w	w	w	w	p	w	w	p	w	p	w	p	w	w	p	w	p	w	p	w	p	w	p	w	p	w	w	p	w	o
o	w	p	w	w	p	w	w	p	w	p	w	p	w	w	w	p	w	w	p	w	w	w	p	p	w	p	w	p	w	w	w	p	w	w	p	w	w	w	w	p	w	p	w	p	w	w	w	p	w	w	w	w	w	p	w	w	p	w	p	w	p	w	w	p	w	p	w	p	w	p	w	p	w	p	w	w	p	w	o
o	w	p	w	w	p	w	w	p	w	p	w	p	w	w	w	p	w	w	p	w	w	w	p	w	w	p	w	p	w	w	w	p	w	w	p	w	w	w	w	p	w	p	w	p	w	w	w	p	w	w	w	w	w	p	w	w	p	w	p	w	p	w	w	p	w	p	w	p	w	p	w	p	w	p	w	w	p	w	o
o	w	p	w	w	p	w	w	p	w	p	w	p	w	w	w	p	w	w	p	w	w	w	p	w	w	w	w	p	w	w	w	p	w	w	w	w	w	w	w	p	w	p	w	p	w	w	w	p	w	w	w	w	w	p	w	w	p	w	p	w	p	w	w	p	w	p	w	p	w	p	w	p	w	p	w	w	p	w	o
o	w	p	w	w	p	w	w	p	w	p	w	p	w	w	w	p	w	w	p	w	w	w	p	w	w	w	w	p	w	w	w	p	w	w	w	w	w	w	w	p	w	w	w	p	w	w	w	p	w	w	w	w	w	p	w	w	p	w	p	w	p	w	w	p	w	p	w	p	w	p	w	p	w	p	w	w	p	w	o
o	w	p	w	w	p	w	w	p	w	p	w	p	w	w	w	w	w	w	p	w	w	w	p	w	w	w	w	p	w	w	w	p	w	w	w	w	w	w	w	p	w	w	w	p	w	w	w	p	w	w	w	w	w	p	w	w	p	w	p	w	p	w	w	p	w	p	w	p	w	p	w	p	w	p	w	w	p	w	o
o	w	p	w	w	p	w	w	p	w	p	w	p	w	w	w	w	w	w	p	w	w	w	p	w	w	w	w	p	w	w	w	p	w	w	w	w	w	w	w	p	w	w	w	p	w	w	w	p	w	w	w	w	w	p	w	w	p	w	p	w	p	w	w	p	w	p	w	p	w	p	w	p	w	p	w	w	p	w	o
o	w	p	w	w	p	w	w	p	w	p	w	p	p	p	p	p	p	p	p	w	w	w	p	w	w	w	w	p	w	w	w	p	w	w	w	w	w	p	p	p	p	p	w	p	w	w	w	p	w	w	w	w	w	p	w	w	p	w	p	w	p	w	w	p	w	p	w	p	w	p	w	p	w	p	w	w	p	w	o
o	w	p	w	w	p	w	w	p	w	p	w	w	w	w	w	w	w	w	p	w	w	w	p	w	w	w	w	p	w	w	w	p	w	w	w	w	w	w	w	w	w	w	w	w	w	w	w	w	w	w	w	w	w	p	w	w	p	w	p	w	p	w	w	p	w	p	w	p	w	p	w	p	w	p	w	w	p	w	o
o	w	p	w	w	p	w	w	p	w	p	p	p	p	p	p	p	p	w	p	p	p	p	p	p	p	p	p	p	p	p	p	p	p	p	p	p	p	p	p	p	p	p	p	p	p	p	p	p	p	p	p	w	p	p	p	w	p	w	p	w	p	w	w	p	w	p	w	p	w	p	w	p	w	p	w	w	p	w	o
o	w	p	w	w	p	w	w	p	w	w	w	w	w	w	w	w	p	w	p	w	w	w	w	p	w	w	w	w	w	w	w	w	w	w	w	w	w	w	w	w	w	w	w	w	w	w	w	w	w	w	w	w	w	p	w	w	p	w	p	w	p	w	w	p	w	p	w	p	w	p	w	p	w	p	w	w	p	w	o
o	w	p	w	w	p	w	w	p	w	w	w	w	w	w	w	w	p	w	p	w	w	p	w	p	w	w	w	w	w	w	w	w	w	w	w	p	p	p	p	p	p	p	p	p	p	p	p	p	p	w	w	w	w	p	w	w	p	w	p	w	p	w	w	p	w	p	w	p	w	p	w	p	w	p	w	w	p	w	o
o	w	p	w	w	p	w	w	p	w	w	w	w	w	w	w	w	p	w	p	w	w	p	w	p	w	w	w	w	w	w	w	w	w	w	w	p	w	w	w	w	w	w	w	p	w	w	p	w	w	w	p	w	w	p	w	w	p	w	p	w	p	w	w	p	w	p	w	p	w	p	w	p	w	p	w	w	p	w	o
o	w	p	w	w	p	w	w	p	w	w	w	w	w	w	w	w	p	w	p	w	w	p	w	p	p	p	p	p	p	p	p	w	w	w	w	p	w	w	w	w	w	w	w	p	w	w	p	w	w	w	p	w	w	p	w	w	p	w	p	w	p	w	w	p	w	p	w	p	w	p	w	p	w	p	w	w	p	w	o
o	w	p	w	p	p	p	p	p	p	p	p	p	p	p	p	w	p	w	p	w	w	p	w	p	w	w	w	w	w	w	p	w	w	w	w	p	w	w	w	p	w	w	w	p	w	w	p	w	w	w	p	w	w	p	w	w	p	w	p	w	p	w	w	p	w	p	w	p	w	p	w	p	w	p	w	w	p	w	o
o	w	p	w	w	p	w	w	p	w	w	w	w	w	w	p	w	p	w	p	w	w	p	w	p	w	w	w	w	w	w	p	w	w	w	w	p	w	w	w	p	w	w	w	p	w	w	p	w	w	w	p	w	w	p	w	w	p	w	p	w	p	w	w	p	w	p	w	p	w	p	w	p	w	p	w	w	p	w	o
o	w	p	w	w	p	w	w	p	w	w	w	w	w	w	p	w	p	w	p	w	w	p	w	p	w	w	w	w	w	w	p	w	w	w	w	p	w	w	w	p	p	p	w	p	w	w	p	w	w	w	p	w	w	p	w	w	p	w	p	w	p	w	w	p	w	p	w	p	w	p	w	p	w	p	w	w	p	w	o
o	w	p	w	w	p	w	w	p	w	w	w	w	w	w	p	w	p	w	p	w	w	p	w	p	w	w	p	w	w	w	p	w	w	w	w	p	w	w	w	p	w	w	w	p	w	w	p	w	w	w	p	w	w	p	w	w	p	w	p	w	p	p	p	p	w	p	w	p	w	p	w	p	w	p	w	w	p	w	o
o	w	p	w	w	p	w	w	p	w	w	w	w	w	w	p	w	p	w	p	w	w	p	w	p	w	w	p	w	w	w	p	w	w	w	w	p	w	w	w	p	w	w	w	p	w	w	p	w	w	w	p	w	w	p	w	w	p	w	p	w	p	w	w	p	w	p	w	p	w	p	w	p	w	p	w	w	p	w	o
o	w	p	w	w	p	w	w	p	w	w	w	w	w	w	p	w	p	w	p	w	w	p	w	p	w	w	p	w	w	w	p	p	p	p	p	p	p	p	w	p	w	w	w	p	w	w	p	w	w	w	p	w	w	p	w	w	p	w	p	w	p	w	w	w	p	p	w	p	p	p	w	p	w	p	w	w	p	w	o
o	w	p	w	w	p	w	w	p	w	w	w	w	w	w	p	w	p	w	p	w	w	p	w	p	w	w	p	w	w	w	p	w	p	w	w	w	w	w	w	p	w	w	w	p	w	w	p	w	w	w	p	w	w	w	w	w	p	w	p	w	p	w	w	w	p	w	w	w	w	w	w	w	w	p	w	w	p	w	o
o	w	p	w	w	p	w	w	p	p	p	p	p	p	w	p	w	p	w	p	w	w	p	w	p	w	w	p	w	w	w	p	w	p	w	w	w	w	w	w	p	w	w	w	p	w	w	p	w	w	w	p	w	w	w	w	w	p	w	p	w	p	w	p	p	p	w	w	w	w	w	w	w	w	p	w	w	p	w	o
o	w	p	w	w	p	w	w	p	w	w	w	w	w	w	p	w	p	w	w	w	w	p	w	p	w	w	p	w	w	w	p	w	p	w	w	w	w	w	w	p	w	w	w	p	w	w	p	w	w	w	p	w	w	w	w	w	p	w	p	w	p	w	p	w	p	p	p	p	w	p	p	p	w	p	w	w	p	w	o
o	w	p	w	w	p	w	w	p	w	w	w	w	w	w	p	w	p	w	w	w	w	p	w	p	w	w	p	w	w	w	p	w	p	w	w	w	w	w	w	p	w	w	w	p	w	w	p	w	w	w	p	w	p	w	w	w	p	w	p	w	p	w	p	w	p	w	p	w	w	p	w	p	w	p	w	w	p	w	o
o	w	p	w	p	p	w	w	p	w	w	w	w	w	w	p	w	p	w	w	w	w	p	w	p	w	w	p	w	w	w	p	w	p	w	w	w	w	w	w	p	w	w	w	p	w	w	p	w	w	w	p	w	p	w	w	w	p	w	p	w	p	w	p	w	p	w	p	p	w	p	w	p	w	p	p	p	p	p	d
o	w	p	w	w	p	w	w	p	w	w	w	w	w	w	p	w	p	w	w	w	w	p	w	p	w	w	p	w	w	w	p	w	p	w	w	w	w	w	w	p	w	w	w	p	w	w	w	w	w	w	p	w	p	w	w	w	p	w	p	w	p	w	p	w	p	w	p	w	w	p	w	p	w	p	w	w	p	w	o
o	w	p	w	w	p	w	w	w	w	w	w	w	w	w	p	w	p	w	w	w	w	p	w	p	w	w	p	w	w	w	p	w	w	p	p	p	p	p	p	p	p	p	p	p	w	p	p	p	p	p	p	p	p	w	w	w	p	w	p	w	p	w	p	w	p	w	p	p	w	p	w	p	w	p	w	w	p	w	o
o	w	p	w	w	p	w	w	w	w	w	w	w	w	w	w	w	p	w	w	w	w	p	w	w	w	w	p	w	w	w	p	w	w	p	w	w	w	w	w	w	w	p	w	p	w	w	w	p	w	w	w	w	p	w	w	w	p	w	p	w	p	w	p	w	p	w	p	w	w	p	w	p	w	p	w	w	p	w	o
o	w	p	w	w	p	w	w	w	w	w	w	w	w	w	p	w	p	w	w	w	w	p	w	w	p	w	p	w	w	w	p	w	w	p	w	w	w	w	w	w	w	p	w	p	w	w	w	p	w	w	w	w	p	w	w	w	p	w	p	w	p	w	p	w	p	w	p	p	w	p	w	p	w	p	w	w	p	w	o
o	w	p	w	w	p	w	w	w	w	w	w	w	w	w	p	w	p	w	w	w	w	p	w	w	p	w	p	w	w	w	p	w	w	p	w	w	p	w	w	w	w	p	w	p	w	w	w	p	w	w	w	w	p	w	w	w	p	w	p	w	p	w	p	w	p	w	p	w	w	p	w	p	w	p	w	w	p	w	o
o	w	p	w	w	p	p	p	p	p	p	p	p	w	w	p	w	p	p	p	p	p	p	p	w	p	w	p	w	w	w	p	w	w	p	w	w	p	w	w	w	w	p	w	p	w	w	w	p	w	w	w	w	p	w	w	w	p	w	p	w	p	w	p	w	p	w	p	p	w	p	w	p	w	p	w	w	p	w	o
o	w	p	p	p	w	w	w	w	w	w	p	w	w	w	p	w	p	w	w	w	p	w	w	w	p	w	p	w	w	w	p	w	w	p	w	w	p	w	w	w	w	p	w	p	w	w	w	p	w	w	w	w	p	w	w	w	p	w	p	w	p	w	p	w	p	w	p	w	w	p	w	p	w	p	w	w	p	w	o
o	w	p	w	w	w	w	w	w	w	w	p	w	w	w	p	w	p	w	w	w	p	w	w	w	p	w	p	w	w	w	p	w	w	p	w	w	p	w	w	w	w	p	w	p	w	w	w	p	w	w	w	w	p	w	w	w	p	w	p	w	p	w	p	w	p	w	p	p	w	p	w	p	w	p	w	w	p	w	o
o	w	p	w	w	w	w	w	w	w	w	p	w	w	w	p	w	p	w	w	w	p	w	w	w	p	w	p	w	w	w	p	w	w	p	w	w	p	w	w	w	w	p	w	p	w	w	w	p	w	w	w	w	p	w	w	w	p	w	p	w	p	w	p	w	p	w	p	w	w	p	w	p	w	p	p	w	p	w	o
o	w	p	w	w	w	w	p	p	p	w	p	w	w	w	p	w	p	w	w	w	p	w	w	w	p	w	p	w	w	w	p	w	w	p	w	w	p	w	w	w	w	p	w	p	w	w	w	p	w	w	w	w	p	w	w	w	p	w	p	w	p	w	p	w	p	w	p	p	w	p	w	w	w	w	p	w	p	w	o
o	w	p	w	w	w	w	p	w	w	w	p	w	w	w	p	w	p	w	w	w	p	w	w	w	p	w	p	w	w	w	p	w	w	p	w	w	p	p	p	p	p	p	w	p	w	w	w	p	w	w	w	w	p	w	w	w	p	w	p	w	p	w	p	w	p	w	p	p	p	p	p	w	w	w	p	w	p	w	o
o	w	p	w	w	w	w	p	w	w	w	p	w	w	w	p	w	p	w	w	w	p	w	w	w	p	w	p	w	w	w	p	w	w	p	w	w	p	w	w	w	w	p	w	p	w	w	w	p	w	w	w	w	p	w	w	w	p	w	p	w	p	w	p	w	p	w	w	w	w	w	w	w	p	w	p	w	p	w	o
o	w	p	p	p	p	w	p	w	w	w	p	w	w	w	p	w	p	w	w	w	p	w	w	w	p	w	p	w	w	w	p	w	w	p	w	w	p	w	w	w	w	p	w	p	w	w	w	p	w	w	w	w	p	w	w	w	p	p	p	w	p	w	p	w	p	p	p	p	w	p	p	w	p	w	p	w	p	w	o
o	w	p	w	w	w	w	p	w	w	w	p	w	w	w	p	w	p	w	w	w	p	w	p	p	p	p	p	p	p	p	p	w	w	p	w	w	p	w	w	w	w	p	w	p	w	w	w	p	w	w	w	w	p	w	w	w	w	w	w	w	w	w	w	w	w	w	w	p	w	p	w	w	p	w	p	w	p	w	o
o	w	p	p	w	p	p	p	p	p	p	p	p	p	p	p	p	p	p	p	w	p	w	w	p	w	p	w	w	w	p	w	w	w	p	w	w	w	w	w	w	w	p	w	w	w	w	w	p	w	w	w	w	p	w	w	w	p	p	p	p	p	p	p	p	p	p	w	p	w	p	p	w	p	w	p	w	p	w	o
o	w	p	w	w	w	w	w	p	w	w	p	w	w	w	p	w	w	w	w	w	p	w	w	p	w	p	w	w	w	p	w	w	w	p	w	w	w	w	w	w	w	p	w	w	w	w	w	p	w	w	w	w	p	w	w	w	w	w	w	p	w	w	w	p	w	p	w	p	w	w	p	w	p	w	p	w	p	w	o
o	w	p	w	p	w	w	w	p	w	w	p	w	w	w	p	w	w	w	w	w	p	w	w	p	w	p	w	w	w	p	w	w	w	p	w	w	p	p	p	p	p	p	w	w	w	w	w	p	w	w	w	w	p	w	w	w	w	w	w	p	w	p	w	p	w	p	w	p	w	p	p	w	p	w	p	w	p	w	o
o	w	p	w	p	w	w	w	p	w	w	p	w	w	w	p	w	w	w	w	w	p	w	w	p	w	p	w	w	w	p	w	w	w	p	w	w	p	w	w	w	w	p	w	w	w	w	w	p	w	w	w	w	p	w	w	w	w	p	w	p	w	p	w	p	w	p	w	p	w	p	w	w	p	w	p	w	p	w	o
o	w	p	w	p	w	w	w	p	w	w	p	w	w	w	p	w	w	w	w	w	p	w	w	p	w	p	w	w	w	p	w	w	w	p	w	w	p	w	w	w	w	p	w	w	w	w	w	p	w	w	w	w	p	w	w	w	w	p	w	p	w	p	w	p	w	p	w	p	w	p	w	w	p	w	p	w	p	w	o
o	w	p	w	p	w	w	w	p	w	w	p	w	w	w	p	w	w	w	w	w	p	w	w	p	w	p	w	w	w	p	w	w	w	p	w	w	p	w	w	w	w	p	w	w	w	w	w	p	w	w	w	w	p	w	w	w	w	p	w	p	w	p	w	p	w	p	w	p	w	p	p	w	p	w	w	w	p	w	o
o	w	p	w	p	w	w	w	p	w	w	p	w	w	w	p	w	w	w	w	w	p	w	w	p	w	p	w	w	w	p	w	w	w	p	w	w	p	w	w	w	w	p	w	w	w	w	w	p	w	w	w	w	p	w	w	w	w	p	w	p	w	p	w	p	w	p	w	p	w	w	p	w	p	p	p	p	p	w	o
o	w	p	w	p	w	w	w	p	w	w	p	w	w	w	p	w	w	w	w	w	p	w	w	p	w	p	w	w	w	p	w	w	w	p	w	w	p	w	w	w	w	p	w	w	w	w	w	w	w	w	w	w	p	w	w	w	w	p	w	p	w	p	w	p	w	p	w	p	w	p	p	w	p	w	w	w	p	w	o
o	w	p	w	p	p	p	p	p	w	w	p	w	w	w	p	w	w	w	w	w	p	w	w	p	w	p	w	w	w	p	w	w	w	p	w	w	w	w	w	w	w	w	w	w	w	w	w	w	w	w	w	w	p	w	w	w	w	p	p	p	p	p	w	w	w	p	w	p	w	p	w	w	p	w	w	w	p	w	o
o	w	p	w	w	w	w	w	p	w	w	p	w	w	w	p	w	w	w	w	w	p	w	w	p	w	p	w	w	w	p	w	w	w	p	p	p	p	p	p	p	p	p	p	p	p	p	p	p	p	p	p	p	p	p	p	p	w	w	p	w	w	w	w	w	w	p	w	p	w	p	p	w	p	w	w	w	p	w	o
o	w	p	w	w	w	w	w	w	w	w	w	w	w	w	p	w	w	w	w	w	w	w	w	p	w	p	w	w	w	p	w	w	w	w	w	w	w	w	w	w	w	w	w	w	w	w	w	w	w	w	w	w	w	w	w	w	w	w	p	p	p	p	w	w	w	p	w	p	w	w	p	w	p	w	w	w	p	w	o
o	w	p	p	p	p	p	p	p	p	w	w	w	w	w	p	p	p	p	p	p	p	p	w	w	w	w	w	w	w	w	w	w	w	w	w	w	w	w	w	w	w	w	w	w	w	w	w	w	w	w	w	w	w	w	w	w	w	w	w	w	w	w	w	w	p	p	w	p	p	p	p	p	p	w	w	p	p	w	o
o	w	w	w	w	w	w	w	w	w	w	w	w	w	w	w	w	w	w	w	w	w	w	w	w	w	w	w	w	w	w	w	w	w	w	w	w	w	w	w	w	w	w	w	w	w	w	w	w	w	w	w	w	w	w	w	w	w	w	w	w	w	w	w	w	w	w	w	w	w	w	w	w	w	w	w	w	w	w	o
o	o	o	o	o	o	o	o	o	o	o	o	o	o	o	o	o	o	o	o	o	o	o	o	o	o	o	o	o	o	o	o	o	o	o	o	o	o	o	o	o	o	o	o	o	o	o	o	o	o	o	o	o	o	o	o	o	o	o	o	o	o	o	o	o	o	o	o	o	o	o	o	o	o	o	o	o	o	o	o
